11111111111111111111
1C000000001000000T01
10000T00000000000PC1
10000000000000000001
100001000C0000000001
10001001000001000001
110000000000000C0101
100000000C10001C0001
1E000001000100000001
100C0000000100C00001
10001000000010000001
100000C000C000000001
100C000000000000T001
11000001010000000001
10000001000000000C01
1000C000000C00100001
1000000000000000CC01
10000T000001000C0C01
1000C00C000000000001
11111111111111111111
