1111111111111111111111
100000000000P000000001
10000T00000000010T0001
110C0000000000C0000011
10C0000000000000000001
10010000000000C0000001
1000000010000010000001
1000000000C00000000001
1000000000C00000000001
1C0000000000000E0T0001
1000000000000000000001
10000T0000000C00000001
1000000000000000000001
1000000000000000000001
100000CC01000000000001
1111111111111111111111